#######
#S#   #
# # # #
#   #E#
#######